2 0 0 0 0 0 0 0 0 0 0 0 0 0 0 0 0 0 0 3
1 9 9 9 9 8 8 0 0 0 8 8 8 8 8 8 8 8 8 1
1 9 8 8 8 8 8 0 0 0 8 8 8 8 8 8 8 8 8 1
1 9 8 8 8 8 8 0 0 0 8 8 8 8 8 8 8 8 8 1
1 9 8 8 8 8 8 0 0 0 8 8 8 8 8 9 9 9 9 1
1 9 9 9 9 8 8 0 0 0 8 8 8 8 8 8 8 8 8 1
1 8 8 8 8 8 8 0 0 0 8 8 8 8 8 8 8 8 8 1
1 8 8 8 8 8 8 0 0 0 8 8 8 8 8 8 8 8 8 1
1 8 8 8 8 8 8 0 0 0 8 8 8 8 8 8 8 8 8 1
1 8 8 8 8 8 8 0 0 0 8 8 8 8 8 8 8 8 8 1
1 8 8 8 8 8 8 0 0 0 8 8 8 8 8 8 8 8 8 1
1 8 8 8 8 8 0 0 0 0 8 8 8 8 8 8 8 8 8 1
1 8 8 8 8 8 0 0 0 0 8 8 8 8 8 8 8 8 8 1
1 8 8 6 6 6 0 0 0 0 6 6 6 6 6 6 6 8 8 1
1 8 8 6 6 6 6 6 0 0 0 0 6 6 6 6 6 8 8 1
1 8 8 6 6 6 6 6 0 0 0 0 6 6 6 6 6 8 8 1
1 8 8 6 6 6 6 6 0 0 0 0 6 6 6 6 6 8 8 1
1 8 8 8 8 8 0 0 0 0 8 8 8 8 8 8 8 8 8 1
1 8 8 8 8 8 0 0 0 0 8 8 8 8 8 8 8 8 8 1
4 0 0 0 0 0 0 0 0 0 0 0 0 0 0 0 0 0 0 5