0 0 0 0 0 0 0 0 0 1 0 0 0 0 0 0 0 0 0 0
2 8 8 8 8 2 2 2 4 3 5 2 2 2 2 2 2 2 2 2
2 8 2 2 2 2 2 2 4 3 5 2 2 2 2 2 2 2 2 2
2 8 2 8 8 2 8 2 4 3 5 2 2 2 2 8 8 8 2 2
2 8 2 2 2 2 8 2 4 3 5 2 2 2 2 2 2 8 2 2
2 8 8 8 8 2 8 2 4 3 5 2 2 2 2 2 2 8 2 2
2 2 2 2 2 2 2 2 4 3 5 2 2 8 2 8 8 8 2 2
2 2 7 2 7 2 2 2 4 3 5 2 2 8 2 2 2 2 2 2
2 2 2 2 7 2 2 2 4 3 5 2 2 8 8 8 8 2 2 2
2 8 8 8 8 2 2 2 4 3 5 2 2 2 2 2 2 2 8 2
2 2 2 2 2 2 2 2 4 3 5 2 2 2 2 2 2 2 8 2
2 2 2 9 10 10 10 10 25 3 3 26 10 10 10 10 15 2 8 2
2 2 2 16 6 6 6 6 27 12 3 13 23 6 6 6 20 2 8 2
2 7 2 16 6 6 6 6 6 27 12 3 13 23 6 6 20 2 8 2
2 7 2 16 6 6 6 6 6 6 21 3 3 22 6 6 20 2 2 2
2 7 2 16 6 6 6 6 6 29 11 3 14 30 6 6 20 2 2 2
2 7 2 17 18 18 18 18 24 11 3 3 28 18 18 18 19 2 2 2
2 7 2 2 2 2 2 2 4 3 3 5 2 2 2 2 2 2 2 2
2 2 2 2 2 2 2 4 3 3 5 2 2 2 2 2 2 2 2 2
0 0 0 0 0 0 0 0 0 0 0 0 0 0 0 0 0 0 0 0

