41 41 41 41 41 41 41 45 43 43 43 54 46 41 41 41 41 41 41 41
42 42 42 42 42 42 42 48 44 44 44 44 47 42 42 42 42 42 42 42
40 40 40 40 40 40 40 40 40 40 40 40 40 40 40 40 40 40 40 40
40 40 40 40 40 40 40 40 57 55 55 58 40 40 40 40 40 40 40 53
40 40 40 40 40 40 40 40 60 56 56 59 40 40 40 40 40 40 40 40
40 40 40 40 40 40 40 40 40 40 40 40 40 40 40 40 40 40 40 40
40 40 40 40 40 40 40 40 40 40 40 40 40 40 40 40 40 40 40 40
40 40 40 49 50 40 49 50 40 40 40 40 49 50 40 49 50 40 40 40
40 40 40 51 52 40 51 52 40 40 40 40 51 52 40 51 52 40 40 40
40 40 40 40 40 40 40 40 40 40 40 40 40 40 40 40 40 40 40 40
40 40 40 49 50 40 49 50 40 40 40 40 49 50 40 49 50 40 40 40
40 40 40 51 52 40 51 52 40 40 40 40 51 52 40 51 52 40 40 40
40 40 40 40 40 40 40 40 40 40 40 40 40 40 40 40 40 40 40 40
40 40 40 49 50 40 49 50 40 40 40 40 49 50 40 49 50 40 40 40
40 40 40 51 52 40 51 52 40 40 40 40 51 52 40 51 52 40 40 40
40 40 40 40 40 40 40 40 40 40 40 40 40 40 40 40 40 40 40 40
40 40 40 49 50 40 49 50 40 40 40 40 49 50 40 49 50 40 40 40
40 40 40 51 52 40 51 52 40 40 40 40 51 52 40 51 52 40 40 40
40 40 40 40 40 40 40 40 40 40 40 40 40 40 40 40 40 40 40 1
40 40 40 40 40 40 40 40 40 40 40 40 40 40 40 40 40 40 40 40
