0 0 0 0 0 0 0 0 0 0 0 0 0 0 0 0 0 0 0 0
8 10 10 10 10 8 8 8 11 9 12 8 8 8 8 8 8 8 8 8
8 10 8 8 8 8 8 8 11 9 12 8 8 8 8 8 8 8 8 8
8 10 8 10 10 8 10 8 11 9 12 8 8 8 8 10 10 10 8 8
8 10 8 8 8 8 10 8 11 9 12 8 8 8 8 8 8 10 8 8
8 10 10 10 10 8 10 8 11 9 12 8 8 8 8 8 8 10 8 8
8 8 8 8 8 8 8 8 11 9 12 8 8 10 8 10 10 10 8 8
8 8 7 8 7 8 8 8 11 9 12 8 8 10 8 8 8 8 8 8
8 8 8 8 7 8 8 8 11 9 12 8 8 10 10 10 10 8 8 8
8 10 10 10 10 8 8 8 11 9 12 8 8 8 8 8 8 8 8 8
8 8 8 8 8 8 8 8 11 9 12 8 8 8 8 8 8 8 8 8
8 8 8 13 14 14 14 14 9 9 9 9 14 14 14 14 15 8 8 8
8 8 8 16 6 6 6 6 9 9 9 9 9 6 6 6 20 8 8 8
8 8 8 16 6 6 6 6 6 9 9 9 9 9 6 6 20 8 8 8
8 8 8 16 6 6 6 6 6 6 9 9 9 9 6 6 20 8 8 8
8 8 8 16 6 6 6 6 6 9 9 9 9 9 6 6 20 8 8 8
8 8 8 17 18 18 18 18 9 9 9 9 9 18 18 18 19 8 8 8
8 8 8 8 8 8 8 8 11 9 9 12 8 8 8 8 8 8 8 8
8 8 8 8 8 8 8 11 9 9 9 8 8 8 8 8 8 8 8 8
0 0 0 0 0 0 0 0 0 0 0 0 0 0 0 0 0 0 0 0