1 1 1 1 1 1 1 5 3 3 3 14 6 1 1 1 1 1 1 1
2 2 2 2 2 2 2 8 4 4 4 4 7 2 2 2 2 2 2 2
0 0 0 0 0 0 0 0 0 0 0 0 0 0 0 0 0 0 0 0
0 0 0 0 0 0 0 0 17 15 15 18 0 0 0 0 0 0 0 13
0 0 0 0 0 0 0 0 20 16 16 19 0 0 0 0 0 0 0 0
0 0 0 0 0 0 0 0 0 0 0 0 0 0 0 0 0 0 0 0
0 0 0 0 0 0 0 0 0 0 0 0 0 0 0 0 0 0 0 0
0 0 0 9 10 0 9 10 0 0 0 0 9 10 0 9 10 0 0 0
0 0 0 11 12 0 11 12 0 0 0 0 11 12 0 11 12 0 0 0
0 0 0 0 0 0 0 0 0 0 0 0 0 0 0 0 0 0 0 0
0 0 0 9 10 0 9 10 0 0 0 0 9 10 0 9 10 0 0 0
0 0 0 11 12 0 11 12 0 0 0 0 11 12 0 11 12 0 0 0
0 0 0 0 0 0 0 0 0 0 0 0 0 0 0 0 0 0 0 0
0 0 0 9 10 0 9 10 0 0 0 0 9 10 0 9 10 0 0 0
0 0 0 11 12 0 11 12 0 0 0 0 11 12 0 11 12 0 0 0
0 0 0 0 0 0 0 0 0 0 0 0 0 0 0 0 0 0 0 0
0 0 0 9 10 0 9 10 0 0 0 0 9 10 0 9 10 0 0 0
0 0 0 11 12 0 11 12 0 0 0 0 11 12 0 11 12 0 0 0
0 0 0 0 0 0 0 0 0 0 0 0 0 0 0 0 0 0 0 0
0 0 0 0 0 0 0 0 0 0 0 0 0 0 0 0 0 0 0 0

