0 0 0 0 0 0 0 0 0 1 0 0 0 0 0 0 0 0 0 0
8 10 10 10 10 8 8 8 11 9 12 8 8 8 8 8 8 8 8 8
8 10 8 8 8 8 8 8 11 9 12 8 8 8 8 8 8 8 8 8
8 10 8 10 10 8 10 8 11 9 12 8 8 8 8 10 10 10 8 8
8 10 8 8 8 8 10 8 11 9 12 8 8 8 8 8 8 10 8 8
8 10 10 10 10 8 10 8 11 9 12 8 8 8 8 8 8 10 8 8
8 8 8 8 8 8 8 8 11 9 12 8 8 10 8 10 10 10 8 8
8 8 7 8 7 8 8 8 11 9 12 8 8 10 8 8 8 8 8 8
8 8 8 8 7 8 8 8 11 9 12 8 8 10 10 10 10 8 8 8
8 10 10 10 10 8 8 8 11 9 12 8 8 8 8 8 8 8 10 8
8 8 8 8 8 8 8 8 11 9 12 8 8 8 8 8 8 8 10 8
8 8 8 13 14 14 14 14 25 9 9 26 14 14 14 14 15 8 10 8
8 8 8 16 6 6 6 6 27 3 9 33 32 6 6 6 20 8 10 8
8 7 8 16 6 6 6 6 6 27 3 9 33 32 6 6 20 8 10 8
8 7 8 16 6 6 6 6 6 6 21 9 9 22 6 6 20 8 8 8
8 7 8 16 6 6 6 6 6 29 2 9 34 30 6 6 20 8 8 8
8 7 8 17 18 18 18 18 24 2 9 9 31 18 18 18 19 8 8 8
8 7 8 8 8 8 8 8 11 9 9 12 8 8 8 8 8 8 8 8
8 8 8 8 8 8 8 11 9 9 12 8 8 8 8 8 8 8 8 8
0 0 0 0 0 0 0 0 0 0 0 0 0 0 0 0 0 0 0 0